5 25
1 2 0 0 0 0 0 0 0 0 0 0 0 0 2 1 2 0 0 0 0 0 0 0 0
1 2 0 0 0 0 0 0 0 0 0 0 0 0 2 2 2 0 0 0 0 0 0 0 0
1 2 0 0 2 2 2 2 2 2 0 0 0 0 0 0 0 0 0 0 0 0 0 0 0
1 2 0 0 2 1 2 1 1 2 0 0 2 2 2 0 0 0 0 0 0 0 0 0 0
1 2 0 0 2 1 2 2 1 2 0 0 2 1 2 0 0 0 0 0 0 0 0 0 0
7
2 1
13 1
14 2
19 2
20 3
22 3
23 4
